0000000000000000000000000
0000000000000000000000000
0000000000000000000000000
00000---------------00000
0000-----------------0000
0000-----------------0000
00000---------------00000
000000-------------000000
0000000-----------0000000
0000000000000000000000000
0000000000000000000000000
0000000000000000000000000
0000000000000000000000000
0000000000000000000000000
0000000000000000000000000
0000000000000000000000000
0000000000000000000000000
0000000000000000000000000
0000000000000000000000000
0000000000000000000000000
0000000000000000000000000